#############
#         P #
# X         #
#           #
#    X     O#
#####       #
#       #####
#P      #
#########